()(((()))(()()()((((()(((())(()(()((((((()(()(((())))((()(((()))((())(()((()()()()(((())(((((((())))()()(()(()(())(((((()()()((())(
((((()()))))()(())(((())(())((((((())())))(()())))()))))()())()())((()()((()()()()(()((((((((()()())((()()(((((()(((())((())(()))()
((((()((((((((())()((()())(())((()))())((((()())(((((((((((()()(((((()(()))())(((()(()))())((()(()())())())(()(((())(())())()()(()(
()((()))((()))))((((()(((()))))((((()(()(()())())()(((()((((())((((()(((()()(())()()()())((()((((((()((()()))()((()))()(()()((())))
(((()(((()))((()((()(()))(((()()(()(()()()))))()()(((()(((())())))))((()(((())()(()(())((()())))((((())))(()(()(()())()((()())))(((
()((()(())()()((()((())(()()((())(())()))()))((()(())()))())(((((((()(()()(()(())())))))))(()((((((())((((())((())())(()()))))()(()
)(()())()())((())(()))))(()))(()((()))()(()((((((()()()()((((((((()(()(())((()()(()()))(())()())()((())))()))()())(((()))(())()(())
()))()((()((()(()()())(())()()()((())())))((()()(()()((()(())()()())(((()(()()))))(())))(()(()())()))()()))))))()))))((((((())))())
))(()(())())(()())))))(()))()))))))()((()))))()))))(()(()((()())())(()()))))(((())()))())())())(((()(()()))(())()(())(())((((((()()
))))((()(()))))))(()))())(((()()(()))()())()()()())))))))))))))(())(()))(()))((()(())(()())(())())(()())(())()()(()())))()()()))(()
)())()))())())(())((())))))))(())))(())))))()))))((())(()(((()))))(()))()((()(())))(()())(((((()))()())()()))))()))))()))())(()(()(
)()))()))))))((()))))))))))()((()))((()(())((())()()(()()))()(()))))()()(()))()))(((())))(())()((())(())(()())()())())))))))())))()
((())))()))(()))()()))(((((((()))())(()()))(()()(()))()(()((()())()))))))(((()()()())))(())()))()())(()()))()()))))))))(())))()))()
()))))))()))()())))()(())(())))))()(())()()(()()))))())((()))))()))))(()(((((()))))))))())))())()(())()()))))(())))())()()())()()()
)()(()))))()))()))))))))())))((()))()))()))())))()())()()())))())))(()((())()((()))())))))())()(())((())))))))))))())()())(())())()
)(()))(()))()))())(()(())())()())()()(()))))(()(())))))))(())))())(())))))))())()()(())())())))(())))))()))()(()())()(()))())()))))
)()()(()))()))))())))))))))()))))()))))))())()())()()))))()())))())))))))))))()()))))()()(((()))()()(())()))))((()))))(()))(())()))
)(())()))))))(()))()))))(())())))))()))(()())))))))))))))())))))))))()((()())(()())))))))((()))))(())(())))()(()())())))())())(()()
()())))()))))))())))))())()()())))))))))))()()(()))))()())()))((()())(()))))()(()))))))))))()())())(((())(()))))())()))()))()))))))
()))))))(()))))()))))()(())))(())))(()))())()()(()()))()))(()()))))))))()))(()))())(()()(()(()())()()))()))))))))(())))))((()()(())
)())())))))()))())(()())()()))())))()(()()()()))((())())))())()(()()))()))))))))(()))(())))()))))(()(()())(()))))()())())()))()()))
())))))))))))())()))))))()))))))))())))))()))))())(()())))(())()))())())))))()()(()()())(()())))()()))(((()))(()()()))))()))))())))
)((())))()((((((()()))))))())))))))))))(((()))))))))))))(())())))))())(()))))))(()))((()))())))()(()((()))()))()))))))))))())()))()
(()()))))())))())(())()(()))()))())(()))()))))(()()))()()(())))))()))(())(()(()()))(()()())))))(((()))))))()))))))))))))(())(()))))
()())())()()((()()))())))))(()))))())))))))()()()))))))))())))()(((()()))(())))))(((())())))))((()))()(()))(()))))(()())))(()))()))
)))()))))(())(())))()((()))(())())))()()))()))))))))()))(()()()(()()()(()))())(())()())(((()))(())))))))))(((()())))()()))))))))()(
())(()))()((((())(())(()())))()))(((())()()()))((()))(()))())())))())))(()))())()())())(()(())())()()()(())))())(())))(())))(())())
)()))(()((()))))))))())(()))))))())(()()))()()))()(()(()())))()()(()((()((((((()))(())))()()()))())()))((()()(()))())((()(()(()))((
)()))))()())))()))()())))))))()()((()())(())))()))(()))(())(()))())(()(())))()()))))))(((()(((()()))()(()(())())((()()))()))()))())
)()(()()()(()))((()())()(())))()()))(((())()()())(())()((()()()()(()(())(()()))()(((((()())))((())))))(()()()))))(((()(())))()))(((
)((()(())()(()((())))((()())()(()))(((()())()()(()))(())(((()((()())()((())()())(((()()))((()((())(()))(()())(()()()))((()))(())(()
((()()())((()))(())))(())(())(())))(()())))(((((()(()(((((()())((((()(()())(())(()()(((())((()(((()()(((()()((((((())))())(()((((((
()(()))()))()()((()((()))))()(()()(()((()()))))))(((((()(((((())()()()(())())))))))()))((()()(())))(())(()()()())))))(()((((())))))
))()()(((()(()(()(()(()())()()()(((((((((()()())()(()))((()()()()()(((((((()())()((())()))((((((()(()(()(()())(((()(((((((()(((())(
((((((((())(())())()))((()(()))(((()()())(())(()(()()(((()(())()))())))(())((((((())(()()())()()(((()(((())(()(((())(((((((()((((((
(((()))(())(()(()(()))))((()))()(())())())((()(()((()()))((()()((()(())(())(()((())(((())(((()()()((((((()()(())((((())()))))(())((
()(()((())))(((((()(()()())())((())())))((())((()((()()((((((())(((()()(()())())(()(()))(()(()))())())()(((((((()(((()(())()()((())
((()(()()((()(()()(((((((((((())((())((((((())((()((((()(()((((()(((((((())()((()))))())()((()((((()(()(((()((()())))(())())(((()((
(())((((((()(((((((((()()(())))(()(((((()((((()())))((()((()((()(()()(((())((((((((((((()(((())(()(((((()))(()()(()()()()()()((())(
((((((())(((((())))))())()(()()(()(()(((()()(((((())(()((()((()(((()()((()((((())()))()((((())(())))()())(((())(())(()()((()(((()()
((((((((((()()(()())())(((((((((())((((()))()()((((())(()((((()(((())())(((((((((((()((((())))(())(()(((()(((()((())(((((()((()()((
)(()()((((((()((((()((()(()((()(()((((((()))))()()(((((()((()(()(())()))(())(((((((()((((()())(()((()((()(()))())))(())((()))))((((
(((()()()())(()))(()()((()())()((()((()()()(()(()()))(()())(())(((((()(((((((((((()((()(((()(((((((()()((((((()(((((()(()((()((((((
))((((((()))((((())((()()((())(((())()(((((()()(((((()((()(()(((((((()(((((()((()((()((())(())((())(()))()()))(()()(()(()()((((((((
)(((()(((())()(((((()((((((()())((((())()((()((()(()()())(()))((((()()((((((()((()(()(()((((()((()((())((((((()(()(())((((((()(((((
(((((()((())()))()(()(()(((((()()()))((())))()(()((((((((((((((()(((()((((()((())((()((()(((()()(()(((()((())(()()())))()(()(()((((
(()()(()(()((((()(((((())()(()(()))(((((()()(((()()(())((((((((((((((())((())(((((((((((())()()()(())()(()(()(((((((((())(((()))(()
()())(()((((()(())(((((()())(())((((((((())()((((()((((((())(()((()(())(((()((((()))(((((((((()()))((((()(())()()()(())(()((())((()
()))()(((())(((((())((((((()()))(((((((((()((((((())))(((((((()((()(()(())))())(()(()))()(((((()())(()))()(()(())(((()))))())()()))
)(((((()))())()((()(()))))((()()()((((((()))()()((((((((())((()(()(((()(()((())((()())(()((((())(()(((()()()(()(()()))())())(((((((
(((())())((()))()((())(())(())))())()(()()(())))())(()))(((()(()()(((()(((())))()(((()(())()((((((())()))()))()((((((()(()(((((()()
)))()))))())()()(((()(((((())((()()(()((()((()(()(()(())))(()()()()((()(())(((()((()))((((()))())(())))())(()))()()()())()))(((()()
())()((())))(())(()()()()(()())((()(()()((((())))((()((()(())((()(()((())()(()()(((()())()()())((()))((())(((()()(())))()()))(((()(
(())()(((((()())(())((())()())())((((((()(()(((((()))(()(
